id;file;predicted_keys;true_labels;true_positive;false_negative;false_positive;f1_score;recall;precision;
0;2.txt;3;6;0;6;3;0.0;0.0;0.0;
1;2002.txt;37;20;2;18;35;0.07017543859649122;0.1;0.05405405405405406;
2;2004.txt;29;17;1;16;28;0.043478260869565216;0.058823529411764705;0.034482758620689655;
3;2009.txt;26;20;1;19;25;0.043478260869565216;0.05;0.038461538461538464;
4;2012.txt;34;24;6;18;28;0.20689655172413793;0.25;0.17647058823529413;
5;2014.txt;47;27;9;18;38;0.24324324324324326;0.3333333333333333;0.19148936170212766;
6;2019.txt;38;35;4;31;34;0.1095890410958904;0.11428571428571428;0.10526315789473684;
7;202.txt;40;17;1;16;39;0.03508771929824561;0.058823529411764705;0.025;
8;2022.txt;14;17;0;17;14;0.0;0.0;0.0;
9;2024.txt;23;22;1;21;22;0.044444444444444446;0.045454545454545456;0.043478260869565216;
10;2029.txt;28;16;3;13;25;0.13636363636363635;0.1875;0.10714285714285714;
11;2032.txt;24;15;3;12;21;0.15384615384615385;0.2;0.125;
12;2039.txt;15;7;0;7;15;0.0;0.0;0.0;
13;204.txt;47;21;5;16;42;0.14705882352941177;0.23809523809523808;0.10638297872340426;
14;2042.txt;45;18;2;16;43;0.06349206349206349;0.1111111111111111;0.044444444444444446;
15;2044.txt;16;17;1;16;15;0.06060606060606061;0.058823529411764705;0.0625;
16;2049.txt;2;8;0;8;2;0.0;0.0;0.0;
17;2052.txt;15;10;1;9;14;0.08;0.1;0.06666666666666667;
18;2054.txt;9;6;1;5;8;0.13333333333333333;0.16666666666666666;0.1111111111111111;
19;2059.txt;7;12;2;10;5;0.21052631578947367;0.16666666666666666;0.2857142857142857;
20;2062.txt;11;9;2;7;9;0.2;0.2222222222222222;0.18181818181818182;
21;2064.txt;12;6;0;6;12;0.0;0.0;0.0;
22;2069.txt;13;10;0;10;13;0.0;0.0;0.0;
23;2082.txt;20;14;3;11;17;0.17647058823529413;0.21428571428571427;0.15;
24;2084.txt;15;9;1;8;14;0.08333333333333333;0.1111111111111111;0.06666666666666667;
25;2089.txt;6;12;1;11;5;0.1111111111111111;0.08333333333333333;0.16666666666666666;
26;209.txt;14;9;1;8;13;0.08695652173913043;0.1111111111111111;0.07142857142857142;
27;2092.txt;43;28;3;25;40;0.08450704225352113;0.10714285714285714;0.06976744186046512;
28;2094.txt;30;10;5;5;25;0.25;0.5;0.16666666666666666;
29;2099.txt;10;13;1;12;9;0.08695652173913043;0.07692307692307693;0.1;
30;2102.txt;11;16;2;14;9;0.14814814814814814;0.125;0.18181818181818182;
31;2104.txt;13;16;1;15;12;0.06896551724137931;0.0625;0.07692307692307693;
32;2109.txt;15;14;1;13;14;0.06896551724137931;0.07142857142857142;0.06666666666666667;
33;2112.txt;14;14;2;12;12;0.14285714285714285;0.14285714285714285;0.14285714285714285;
34;2114.txt;14;9;2;7;12;0.17391304347826086;0.2222222222222222;0.14285714285714285;
35;2119.txt;18;12;1;11;17;0.06666666666666667;0.08333333333333333;0.05555555555555555;
36;212.txt;14;12;1;11;13;0.07692307692307693;0.08333333333333333;0.07142857142857142;
37;2122.txt;31;14;4;10;27;0.17777777777777778;0.2857142857142857;0.12903225806451613;
38;2124.txt;20;10;3;7;17;0.2;0.3;0.15;
39;2129.txt;19;8;3;5;16;0.2222222222222222;0.375;0.15789473684210525;
40;2132.txt;27;11;3;8;24;0.15789473684210525;0.2727272727272727;0.1111111111111111;
41;2134.txt;24;16;2;14;22;0.1;0.125;0.08333333333333333;
42;2139.txt;16;9;3;6;13;0.24;0.3333333333333333;0.1875;
43;214.txt;30;15;6;9;24;0.26666666666666666;0.4;0.2;
44;2142.txt;28;11;7;4;21;0.358974358974359;0.6363636363636364;0.25;
45;2144.txt;10;7;2;5;8;0.23529411764705882;0.2857142857142857;0.2;
46;2149.txt;10;6;2;4;8;0.25;0.3333333333333333;0.2;
47;2152.txt;21;12;4;8;17;0.24242424242424243;0.3333333333333333;0.19047619047619047;
48;2154.txt;19;12;1;11;18;0.06451612903225806;0.08333333333333333;0.05263157894736842;
49;2159.txt;22;12;3;9;19;0.17647058823529413;0.25;0.13636363636363635;
50;2162.txt;8;8;0;8;8;0.0;0.0;0.0;
51;2164.txt;11;7;0;7;11;0.0;0.0;0.0;
52;2169.txt;3;7;0;7;3;0.0;0.0;0.0;
53;2172.txt;20;12;2;10;18;0.125;0.16666666666666666;0.1;
54;2174.txt;8;7;0;7;8;0.0;0.0;0.0;
55;2179.txt;27;13;4;9;23;0.2;0.3076923076923077;0.14814814814814814;
56;2182.txt;24;8;2;6;22;0.125;0.25;0.08333333333333333;
57;2184.txt;12;5;2;3;10;0.23529411764705882;0.4;0.16666666666666666;
58;2189.txt;16;5;3;2;13;0.2857142857142857;0.6;0.1875;
59;219.txt;5;7;0;7;5;0.0;0.0;0.0;
60;2192.txt;24;11;2;9;22;0.11428571428571428;0.18181818181818182;0.08333333333333333;
61;2194.txt;11;11;1;10;10;0.09090909090909091;0.09090909090909091;0.09090909090909091;
62;2199.txt;5;13;0;13;5;0.0;0.0;0.0;
63;22.txt;16;11;0;11;16;0.0;0.0;0.0;
64;224.txt;16;6;1;5;15;0.09090909090909091;0.16666666666666666;0.0625;
65;229.txt;1;3;0;3;1;0.0;0.0;0.0;
66;232.txt;28;21;4;17;24;0.16326530612244897;0.19047619047619047;0.14285714285714285;
67;234.txt;14;13;0;13;14;0.0;0.0;0.0;
68;239.txt;27;9;4;5;23;0.2222222222222222;0.4444444444444444;0.14814814814814814;
69;24.txt;15;12;5;7;10;0.37037037037037035;0.4166666666666667;0.3333333333333333;
70;242.txt;15;8;2;6;13;0.17391304347826086;0.25;0.13333333333333333;
71;244.txt;23;7;2;5;21;0.13333333333333333;0.2857142857142857;0.08695652173913043;
72;249.txt;11;15;0;15;11;0.0;0.0;0.0;
73;252.txt;11;18;0;18;11;0.0;0.0;0.0;
74;254.txt;6;10;1;9;5;0.125;0.1;0.16666666666666666;
75;259.txt;20;20;2;18;18;0.1;0.1;0.1;
76;262.txt;9;15;2;13;7;0.16666666666666666;0.13333333333333333;0.2222222222222222;
77;264.txt;18;13;6;7;12;0.3870967741935484;0.46153846153846156;0.3333333333333333;
78;269.txt;29;21;7;14;22;0.28;0.3333333333333333;0.2413793103448276;
79;272.txt;25;18;1;17;24;0.046511627906976744;0.05555555555555555;0.04;
80;274.txt;29;29;0;29;29;0.0;0.0;0.0;
81;279.txt;20;20;3;17;17;0.15;0.15;0.15;
82;282.txt;9;12;2;10;7;0.19047619047619047;0.16666666666666666;0.2222222222222222;
83;284.txt;29;23;3;20;26;0.11538461538461539;0.13043478260869565;0.10344827586206896;
84;289.txt;23;21;3;18;20;0.13636363636363635;0.14285714285714285;0.13043478260869565;
85;29.txt;31;23;6;17;25;0.2222222222222222;0.2608695652173913;0.1935483870967742;
86;292.txt;48;23;4;19;44;0.11267605633802817;0.17391304347826086;0.08333333333333333;
87;294.txt;26;14;1;13;25;0.05;0.07142857142857142;0.038461538461538464;
88;299.txt;13;8;1;7;12;0.09523809523809523;0.125;0.07692307692307693;
89;APCollegePhysics-OP_js6ZFp7.txt;1092;104;60;44;1032;0.10033444816053512;0.5769230769230769;0.054945054945054944;
90;J-1.txt;124;15;3;12;121;0.04316546762589928;0.2;0.024193548387096774;
91;J-10.txt;125;14;2;12;123;0.02877697841726619;0.14285714285714285;0.016;
92;J-11.txt;162;17;4;13;158;0.0446927374301676;0.23529411764705882;0.024691358024691357;
93;J-13.txt;112;14;2;12;110;0.031746031746031744;0.14285714285714285;0.017857142857142856;
94;J-14.txt;102;13;5;8;97;0.08695652173913043;0.38461538461538464;0.049019607843137254;
95;J-15.txt;234;9;1;8;233;0.00823045267489712;0.1111111111111111;0.004273504273504274;
96;J-17.txt;131;13;5;8;126;0.06944444444444445;0.38461538461538464;0.03816793893129771;
97;J-18.txt;90;13;4;9;86;0.07766990291262135;0.3076923076923077;0.044444444444444446;
98;J-4.txt;130;13;5;8;125;0.06993006993006994;0.38461538461538464;0.038461538461538464;
99;J-7.txt;143;16;1;15;142;0.012578616352201259;0.0625;0.006993006993006993;
100;J-8.txt;138;23;6;17;132;0.07453416149068323;0.2608695652173913;0.043478260869565216;
101;J-9.txt;190;29;12;17;178;0.1095890410958904;0.17876440574193117;0.09442942101604247;
