id;file;predicted_keys;true_labels;true_positive;false_negative;false_positive;f1_score;recall;precision;
0;2.txt;3;6;1;5;2;0.2222222222222222;0.16666666666666666;0.3333333333333333;
1;2002.txt;33;20;2;18;31;0.07547169811320754;0.1;0.06060606060606061;
2;2004.txt;25;17;1;16;24;0.047619047619047616;0.058823529411764705;0.04;
3;2009.txt;44;20;7;13;37;0.21875;0.35;0.1590909090909091;
4;2012.txt;31;24;7;17;24;0.2545454545454545;0.2916666666666667;0.22580645161290322;
5;2014.txt;43;27;8;19;35;0.22857142857142856;0.2962962962962963;0.18604651162790697;
6;2019.txt;36;35;6;29;30;0.16901408450704225;0.17142857142857143;0.16666666666666666;
7;202.txt;37;17;2;15;35;0.07407407407407407;0.11764705882352941;0.05405405405405406;
8;2022.txt;17;17;0;17;17;0.0;0.0;0.0;
9;2024.txt;37;22;5;17;32;0.1694915254237288;0.22727272727272727;0.13513513513513514;
10;2029.txt;22;16;3;13;19;0.15789473684210525;0.1875;0.13636363636363635;
11;2032.txt;24;15;6;9;18;0.3076923076923077;0.4;0.25;
12;2039.txt;15;7;2;5;13;0.18181818181818182;0.2857142857142857;0.13333333333333333;
13;204.txt;65;21;9;12;56;0.20930232558139536;0.42857142857142855;0.13846153846153847;
14;2042.txt;48;18;3;15;45;0.09090909090909091;0.16666666666666666;0.0625;
15;2044.txt;16;17;1;16;15;0.06060606060606061;0.058823529411764705;0.0625;
16;2049.txt;4;8;2;6;2;0.3333333333333333;0.25;0.5;
17;2052.txt;3;10;0;10;3;0.0;0.0;0.0;
18;2054.txt;9;6;2;4;7;0.26666666666666666;0.3333333333333333;0.2222222222222222;
19;2059.txt;5;12;1;11;4;0.11764705882352941;0.08333333333333333;0.2;
20;2062.txt;13;9;2;7;11;0.18181818181818182;0.2222222222222222;0.15384615384615385;
21;2064.txt;16;6;2;4;14;0.18181818181818182;0.3333333333333333;0.125;
22;2069.txt;11;10;1;9;10;0.09523809523809523;0.1;0.09090909090909091;
23;2082.txt;26;14;3;11;23;0.15;0.21428571428571427;0.11538461538461539;
24;2084.txt;19;9;1;8;18;0.07142857142857142;0.1111111111111111;0.05263157894736842;
25;2089.txt;14;12;1;11;13;0.07692307692307693;0.08333333333333333;0.07142857142857142;
26;209.txt;12;9;0;9;12;0.0;0.0;0.0;
27;2092.txt;44;28;6;22;38;0.16666666666666666;0.21428571428571427;0.13636363636363635;
28;2094.txt;15;10;2;8;13;0.16;0.2;0.13333333333333333;
29;2099.txt;20;13;2;11;18;0.12121212121212122;0.15384615384615385;0.1;
30;2102.txt;13;16;2;14;11;0.13793103448275862;0.125;0.15384615384615385;
31;2104.txt;11;16;2;14;9;0.14814814814814814;0.125;0.18181818181818182;
32;2109.txt;18;14;2;12;16;0.125;0.14285714285714285;0.1111111111111111;
33;2112.txt;17;14;3;11;14;0.1935483870967742;0.21428571428571427;0.17647058823529413;
34;2114.txt;9;9;1;8;8;0.1111111111111111;0.1111111111111111;0.1111111111111111;
35;2119.txt;14;12;1;11;13;0.07692307692307693;0.08333333333333333;0.07142857142857142;
36;212.txt;11;12;1;11;10;0.08695652173913043;0.08333333333333333;0.09090909090909091;
37;2122.txt;29;14;5;9;24;0.23255813953488372;0.35714285714285715;0.1724137931034483;
38;2124.txt;16;10;4;6;12;0.3076923076923077;0.4;0.25;
39;2129.txt;14;8;3;5;11;0.2727272727272727;0.375;0.21428571428571427;
40;2132.txt;27;11;3;8;24;0.15789473684210525;0.2727272727272727;0.1111111111111111;
41;2134.txt;23;16;2;14;21;0.10256410256410256;0.125;0.08695652173913043;
42;2139.txt;22;9;3;6;19;0.1935483870967742;0.3333333333333333;0.13636363636363635;
43;214.txt;30;15;4;11;26;0.17777777777777778;0.26666666666666666;0.13333333333333333;
44;2142.txt;28;11;9;2;19;0.46153846153846156;0.8181818181818182;0.32142857142857145;
45;2144.txt;2;7;0;7;2;0.0;0.0;0.0;
46;2149.txt;11;6;2;4;9;0.23529411764705882;0.3333333333333333;0.18181818181818182;
47;2152.txt;19;12;4;8;15;0.25806451612903225;0.3333333333333333;0.21052631578947367;
48;2154.txt;17;12;1;11;16;0.06896551724137931;0.08333333333333333;0.058823529411764705;
49;2159.txt;25;12;3;9;22;0.16216216216216217;0.25;0.12;
50;2162.txt;19;8;2;6;17;0.14814814814814814;0.25;0.10526315789473684;
51;2164.txt;15;7;0;7;15;0.0;0.0;0.0;
52;2169.txt;8;7;2;5;6;0.26666666666666666;0.2857142857142857;0.25;
53;2172.txt;25;12;4;8;21;0.21621621621621623;0.3333333333333333;0.16;
54;2174.txt;4;7;0;7;4;0.0;0.0;0.0;
55;2179.txt;33;13;5;8;28;0.21739130434782608;0.38461538461538464;0.15151515151515152;
56;2182.txt;16;8;1;7;15;0.08333333333333333;0.125;0.0625;
57;2184.txt;17;5;2;3;15;0.18181818181818182;0.4;0.11764705882352941;
58;2189.txt;11;5;2;3;9;0.25;0.4;0.18181818181818182;
59;219.txt;1;7;0;7;1;0.0;0.0;0.0;
60;2192.txt;19;11;3;8;16;0.2;0.2727272727272727;0.15789473684210525;
61;2194.txt;12;11;2;9;10;0.17391304347826086;0.18181818181818182;0.16666666666666666;
62;2199.txt;5;13;0;13;5;0.0;0.0;0.0;
63;22.txt;16;11;1;10;15;0.07407407407407407;0.09090909090909091;0.0625;
64;224.txt;16;6;2;4;14;0.18181818181818182;0.3333333333333333;0.125;
65;229.txt;10;3;1;2;9;0.15384615384615385;0.3333333333333333;0.1;
66;232.txt;32;21;3;18;29;0.11320754716981132;0.14285714285714285;0.09375;
67;234.txt;22;13;4;9;18;0.22857142857142856;0.3076923076923077;0.18181818181818182;
68;239.txt;35;9;5;4;30;0.22727272727272727;0.5555555555555556;0.14285714285714285;
69;24.txt;18;12;7;5;11;0.4666666666666667;0.5833333333333334;0.3888888888888889;
70;242.txt;11;8;2;6;9;0.21052631578947367;0.25;0.18181818181818182;
71;244.txt;24;7;3;4;21;0.1935483870967742;0.42857142857142855;0.125;
72;249.txt;13;15;0;15;13;0.0;0.0;0.0;
73;252.txt;4;18;0;18;4;0.0;0.0;0.0;
74;254.txt;4;10;1;9;3;0.14285714285714285;0.1;0.25;
75;259.txt;22;20;4;16;18;0.19047619047619047;0.2;0.18181818181818182;
76;262.txt;21;15;4;11;17;0.2222222222222222;0.26666666666666666;0.19047619047619047;
77;264.txt;14;13;5;8;9;0.37037037037037035;0.38461538461538464;0.35714285714285715;
78;269.txt;15;21;1;20;14;0.05555555555555555;0.047619047619047616;0.06666666666666667;
79;272.txt;18;18;2;16;16;0.1111111111111111;0.1111111111111111;0.1111111111111111;
80;274.txt;21;29;0;29;21;0.0;0.0;0.0;
81;279.txt;29;20;5;15;24;0.20408163265306123;0.25;0.1724137931034483;
82;282.txt;14;12;5;7;9;0.38461538461538464;0.4166666666666667;0.35714285714285715;
83;284.txt;33;23;4;19;29;0.14285714285714285;0.17391304347826086;0.12121212121212122;
84;289.txt;23;21;2;19;21;0.09090909090909091;0.09523809523809523;0.08695652173913043;
85;29.txt;29;23;7;16;22;0.2692307692307692;0.30434782608695654;0.2413793103448276;
86;292.txt;45;23;3;20;42;0.08823529411764706;0.13043478260869565;0.06666666666666667;
87;294.txt;29;14;2;12;27;0.09302325581395349;0.14285714285714285;0.06896551724137931;
88;299.txt;15;8;2;6;13;0.17391304347826086;0.25;0.13333333333333333;
89;APCollegePhysics-OP_js6ZFp7.txt;803;104;59;45;744;0.13009922822491732;0.5673076923076923;0.07347447073474471;
90;J-1.txt;69;15;2;13;67;0.047619047619047616;0.13333333333333333;0.028985507246376812;
91;J-10.txt;73;14;2;12;71;0.04597701149425287;0.14285714285714285;0.0273972602739726;
92;J-11.txt;75;17;3;14;72;0.06521739130434782;0.17647058823529413;0.04;
93;J-13.txt;63;14;2;12;61;0.05194805194805195;0.14285714285714285;0.031746031746031744;
94;J-14.txt;64;13;4;9;60;0.1038961038961039;0.3076923076923077;0.0625;
95;J-15.txt;105;9;1;8;104;0.017543859649122806;0.1111111111111111;0.009523809523809525;
96;J-17.txt;83;13;5;8;78;0.10416666666666667;0.38461538461538464;0.060240963855421686;
97;J-18.txt;59;13;4;9;55;0.1111111111111111;0.3076923076923077;0.06779661016949153;
98;J-4.txt;62;13;5;8;57;0.13333333333333333;0.38461538461538464;0.08064516129032258;
99;J-7.txt;76;16;1;15;75;0.021739130434782608;0.0625;0.013157894736842105;
100;J-8.txt;80;23;3;20;77;0.05825242718446602;0.13043478260869565;0.0375;
101;J-9.txt;98;29;13;16;85;0.2047244094488189;0.21834471617376444;0.12514329016968023;
